occur argue load dance hammer conduct over shop addict assault pole sad	sSJaBGs5QmazVPBwNcCjhv99VJqfqQ731d
gown off bulk artist lounge reject frame perfect piece muffin poverty prefer	seyx3kzbcosh3GrjTDuE9z4vaBbsiFPsFP
corn safe keep teach thought artefact quality rule amused improve oval sphere	sYVC1FNJG4Rtis78KeYuLLnMuJg4qmjG9c
enforce raise ticket vanish stable gossip stick blossom trial body exile sudden	sPDCsfNbsS6kzZb8XhWCrd2Ws7xHr31ogi
stairs armed model high upon traffic zebra doctor angle squirrel evil dance	sW1JNUZPgPgy8dDbVybgMcggGpk82Q3r2x
few canvas frozen devote nation curious rabbit shiver blouse omit diesel oppose	sTaNiGvdsTFnF8ucpuUBNN3eBNRSDZ7tu4
model kick found alarm loop soccer raccoon sauce question coast spawn artist	sfDRxejdNAh2pvi5LSkyNAEvPXfBpemVj3
double source tent iron that key empower grocery swim matrix evolve brave	sfV326XsqDNMgzk9dPwAKPjPdSQcA9Z32T
tag today thrive alter minor icon pistol amateur reject plug merit will	sQJk9YHFcBUCPKGHnopuawtV7kyes9CHAS
repair gate wine abandon slow strong hero process bless van pudding human	saW8vf1NncywhTF61pzisqTb9x68yDVE3j
cargo craft mix west flip muffin afford slice lottery rubber common fiscal	shQWkvNbrf3qCSEi8kR5yXQLDsKs7jEhm4
learn absent hand sad ginger into system very truly choice tiger brave	sN8g3yoBJiabgaRs4d8EyEenVc3RMS8fzd
car supreme fun tornado upper grit ice once one alert neck timber	sfu42fXcHEYMKbbSMe8pufdQZu1hPQTE1p
few trigger axis age key correct thing horn rebuild card plastic fish	scV9NmXttTu9f5iYcY9dRpR9boFyZTXNzt
atom town pill wonder auto gospel pride owner stand notable fame curious	sXmBXhwMhHd6b15QLFdTCE32J6B8ZwnMtQ
birth settle icon page night shadow noise stumble earth copy hand length	sKg9QvS3uqMdgEBAjYUgucjHu639fdU13c
drive assist tragic possible tape omit finger visual click attract ready marine	sdAtfgf7882m2jUyquujknuxAw6k8aJh76
world royal beef muffin bronze endorse enhance client kingdom task spot merge	sK5QYTiK53DYyW3VziU1aD6MkN7EWo2oVD
decorate portion tray special ketchup horse orbit between swift sure approve sustain	sUm596jEBCbcv77ZzXrUk33cP6827Z8Jsp
woman virus era volume galaxy disagree aisle test sunny aspect thumb property	sMosf6RUgaN8VTLivEQbQZ1NkVRZHs8x1o
search local jealous october bench blanket office hurt venture whale kick there	sLrhaakoL41xBJLGXxQMgvRXXqLSmXKi3w
process sure rough inquiry wheat dizzy stadium party unlock midnight slab couch	sWTVA1A6V7B15UMDV2NFL4wVUL1EZPCfmF
scheme virus mesh wonder real skin syrup weather toward indoor frozen palace	sdnZeauxhQaWuS1UsdUxGA1S7FmUGP7XQN
owner ceiling tissue remember coach drastic gossip flash sense siren pear twin	sViwV6Rf6cp7jStpfyiy6pYoMziFtz54YY
zebra rare know ginger eye dish hour parrot wall arch canal mosquito	sUpGaApAn82e94Qbr6emf1ucFkKRVPbmTu
matrix unaware kind island quality service hundred bamboo client traffic connect cash	sKtq8zj5tcAx1ZkD7zfA4vtzGF9WmvA5Vu
satoshi agent recall depend tomato rate turkey girl use angry crumble senior	sY2KQm2hHZEw7yP5BKhR1XweyFBQ1BnruX
spray sunny outer sponsor diesel off silver outdoor rival file treat practice	scu8GdqsSPsbhqCiiWRWSQwY96q6rqsHMs
cruel nest hundred tip bench near symptom dinner exercise army pony note	sQKmT8dgYGF9XZ2JxZm48TMJBpwiFfWU5u
arch ask gallery cancel loan embark track inflict loop sting ship huge	sPPj19X86gi1sVUKxpxtLVUGfM6G1gKWBk
panda album lunch hammer quality replace suggest bomb wide fresh seat base	sXEu56LY4iCHFggQxAbcQ6fS5PJRJjTHs2
acquire ski connect royal deputy police clinic vacuum tornado beef cigar stage	sKqN1KH9LrRkPWF2wf6ej49TQbhNKPbaAg
float phone shell regret saddle mind fork bulk wagon evolve sniff spoil	saYHSsrHfQABHE1NbBaP1FDtnePMFiiLTU
need record sorry concert blossom amazing accuse someone asset flower sun spider	saoaCJ71vw2HQfLu8BYJHDr7fXEkNr9sGu
suspect universe girl liar cry jealous bread bunker bunker chief exercise rude	sX2qXWDT9WVhEHoUiqMDhdqeuPQgWxZiym
review suspect blade denial head brother know away east tennis retire double	sQ2AGDz6aZtHnjJjsPdzJd3fHCEJzKLWVu
head rule tide horn canvas bind tone survey front dynamic recipe business	sNEEaTZF4BFioGJ4GQ1v3mreAySbzKnJLt
slim snack bag mammal orchard mixed smoke sting deny reject firm loyal	sbrEwrwPWV4QEcNSV9rdsvPXoYiNDFruNk
enroll jacket submit until dirt drip prepare holiday crime ocean position quiz	seiN8mRvF78LMDKyCqywFUPM9RCYR8tr2r
change crazy sight scare diet supreme artwork clarify stick ketchup actress this	scX4x6GoN4e4UB4ToKjcq4MBbzvuMZz1wy
grief brick hello raven special blur sunny bar page surge become army	sTByJYJSRRSfyTLAu4LZuyrd7LESJJa6qP
rich amateur elephant deer alert surprise tomato among drift erupt jar hamster	sXqaMzB3tf5XZ4az2Vx8SncAVp7w92AapP
bless flat bitter echo chunk nerve trim sorry rib habit awkward merit	sZMZPkJrqtSiyr1EBedeizSverDoK9odTi
energy champion april possible fold parent spatial lucky crane obvious harbor rely	sTBNvJfGMwRX4d6cQ79Wfuuj4BEitrBMxF
soup wood local garden alarm lucky happy camp reduce number mix merry	sTEqbqBg1apx2q3vKhWH9WgzDnxGctGpwa
donkey into combine danger art have alpha opinion vague powder pepper about	sPoBvkSK1hAGRnzJHVaYKszzgCQEBtaVun
doctor victory mask reason birth bar pretty riot kidney post service catalog	se4bGxZnb8S99UPJp85TQ98A8EymWPkivr
feel barely visa trumpet picnic rib whip scare scheme youth arm toy	sXXBjFhFFDufesqdTeaG8dvBLWDhsP8zBn
common royal onion play ranch assist truly rain unable excite daughter remind	sKY8B9EraQrTRyzpxVrKMgJ1G5bVzcZwXK
together about below caution color better mystery horse phrase axis adjust bulk	sefRbfBWpcyAsW13pFGSZjLdyBHdSxH7jh
